000000000000000000000000
000000000000000000000000
000222000222000000000000
000000000000000000000000
000000000000000000000000
000000000000000000000000
000030030030003000000000
111111111111111111111111
111111111111111111111111
111111111111111111111111
111111111111111111111111
